1,0,0,5,0,0,0,6,5,0,0,5,2,7,0
0,15,15,14,15,15,15,15,15,15,15,15,15,15,0
0,15,15,15,0,15,15,15,15,15,0,0,15,15,5
6,15,12,0,0,15,14,15,15,15,12,14,15,15,1
2,15,0,0,15,15,0,0,0,15,15,0,0,15,6
5,15,15,15,15,15,15,15,15,15,15,15,15,15,0
5,0,15,0,0,15,0,0,0,15,15,15,15,15,0
7,15,15,0,0,15,12,0,15,0,0,0,0,0,2
0,15,15,15,0,15,15,15,15,13,0,15,15,15,0
5,15,14,0,0,15,15,15,15,12,15,15,13,15,5
3,15,15,15,15,15,15,15,15,15,15,15,15,15,7
0,6,0,0,5,6,3,0,6,0,0,5,0,0,0