1,0,0,5,0,0,0,6,5,0,0,5,2,7,0
10,15,15,14,15,15,15,15,15,15,15,15,15,15,0
9,15,15,15,0,15,15,15,15,15,1,0,15,15,5
8,15,12,5,1,15,14,15,15,15,12,14,15,15,11
2,15,3,2,15,15,7,15,6,15,15,2,0,15,8
5,15,15,15,15,15,15,15,15,15,15,15,15,15,0
5,6,15,0,0,15,6,4,0,15,15,15,15,15,0
0,15,15,5,3,15,12,0,15,15,1,2,5,6,2
11,15,15,15,0,15,15,15,15,13,0,15,15,15,10
9,15,14,15,13,15,15,15,15,12,15,15,13,15,9
9,15,15,15,15,15,15,15,15,15,15,15,15,15,8
8,6,4,0,5,6,3,0,6,0,0,5,4,0,0